000000000000000
011111111111110
011111111111110
013131331131310
011113111113110
011111311133110
011333131111310
011113132131110
031113111111310
011311131113110
013111311111110
013113133131110
011111131111110
011111313111110
011111111111110
000000000000000

