0000000000000
0313133113130
0111311311310
0111131113310
0133313311130
0111313113110
0311311111130
0113113111310
0131131211110
0131313313110
0111113111110
0111131311110
0000000000000

